#================================================#
#= General =#
#================================================#
net.minecraft.src=net.minecraft.server

#================================================#
#= Classes =#
#================================================#
AABBPool=AABBPool
AABBLocalPool=AABBPoolThreadLocal
Achievement=Achievement
AchievementList=AchievementList
AchievementMap=AchievementMap
AxisAlignedBB=AxisAlignedBB
BanEntry=BanEntry
BanList=BanList
BiomeGenBase=BiomeBase
BiomeGenBeach=BiomeBeach
BiomeGenHills=BiomeBigHills
BiomeCache=BiomeCache
BiomeCacheBlock=BiomeCacheBlock
BiomeDecorator=BiomeDecorator
BiomeGenDesert=BiomeDesert
BiomeGenForest=BiomeForest
BiomeGenHell=BiomeHell
BiomeGenSnow=BiomeIcePlains
BiomeGenJungle=BiomeJungle
SpawnListEntry=BiomeMeta
BiomeGenMushroomIsland=BiomeMushrooms
BiomeGenOcean=BiomeOcean
BiomeGenPlains=BiomePlains
BiomeGenRiver=BiomeRiver
BiomeGenSwamp=BiomeSwamp
BiomeGenTaiga=BiomeTaiga
BiomeGenEnd=BiomeTheEnd
BiomeEndDecorator=BiomeTheEndDecorator
Block=Block
BlockAnvil=BlockAnvil
BlockBeacon=BlockBeacon
BlockBed=BlockBed
BlockNetherrack=BlockBloodStone
BlockBookshelf=BlockBookshelf
BlockBrewingStand=BlockBrewingStand
BlockButton=BlockButton
BlockCactus=BlockCactus
BlockCake=BlockCake
BlockCarrot=BlockCarrots
BlockCauldron=BlockCauldron
BlockChest=BlockChest
BlockClay=BlockClay
BlockCloth=BlockCloth
BlockWall=BlockCobbleWall
BlockCocoa=BlockCocoa
BlockCommandBlock=BlockCommand
BlockContainer=BlockContainer
BlockCrops=BlockCrops
BlockDeadBush=BlockDeadBush
BlockRedstoneRepeater=BlockDiode
BlockDirectional=BlockDirectional
BlockDirt=BlockDirt
BlockDispenser=BlockDispenser
BlockDoor=BlockDoor
BlockDragonEgg=BlockDragonEgg
BlockEnchantmentTable=BlockEnchantmentTable
BlockEnderChest=BlockEnderChest
BlockEndPortal=BlockEnderPortal
BlockEndPortalFrame=BlockEnderPortalFrame
BlockFence=BlockFence
BlockFenceGate=BlockFenceGate
BlockFire=BlockFire
BlockFlower=BlockFlower
BlockFlowerPot=BlockFlowerPot
BlockFlowing=BlockFlowing
BlockFluid=BlockFluids
BlockFurnace=BlockFurnace
BlockGlass=BlockGlass
BlockGrass=BlockGrass
BlockGravel=BlockGravel
BlockBreakable=BlockHalfTransparant
BlockMushroomCap=BlockHugeMushroom
BlockIce=BlockIce
BlockJukeBox=BlockJukeBox
BlockLadder=BlockLadder
BlockLeaves=BlockLeaves
BlockLever=BlockLever
BlockGlowStone=BlockLightStone
BlockLockedChest=BlockLockedChest
BlockLog=BlockLog
BlockTallGrass=BlockLongGrass
BlockMelon=BlockMelon
BlockDetectorRail=BlockMinecartDetector
BlockRail=BlockMinecartTrack
BlockMobSpawner=BlockMobSpawner
BlockSilverfish=BlockMonsterEggs
BlockMushroom=BlockMushroom
BlockMycelium=BlockMycel
BlockNetherStalk=BlockNetherWart
BlockNote=BlockNote
BlockObsidian=BlockObsidian
BlockOre=BlockOre
BlockOreStorage=BlockOreBlock
BlockPistonBase=BlockPiston
BlockPistonExtension=BlockPistonExtension
BlockPistonMoving=BlockPistonMoving
BlockPortal=BlockPortal
BlockPotato=BlockPotatoes
BlockPressurePlate=BlockPressurePlate
BlockPumpkin=BlockPumpkin
BlockRedstoneLight=BlockRedstoneLamp
BlockRedstoneOre=BlockRedstoneOre
BlockRedstoneTorch=BlockRedstoneTorch
BlockRedstoneWire=BlockRedstoneWire
BlockReed=BlockReed
BlockSand=BlockSand
BlockSandStone=BlockSandStone
BlockSapling=BlockSapling
BlockSign=BlockSign
BlockSkull=BlockSkull
BlockSoulSand=BlockSlowSand
BlockStoneBrick=BlockSmoothBrick
BlockSnow=BlockSnow
BlockSnowBlock=BlockSnowBlock
BlockFarmland=BlockSoil
BlockSponge=BlockSponge
BlockStairs=BlockStairs
BlockStationary=BlockStationary
BlockStem=BlockStem
BlockStep=BlockStep
BlockHalfSlab=BlockStepAbstract
BlockStone=BlockStone
BlockTNT=BlockTNT
BlockPane=BlockThinFence
BlockTorch=BlockTorch
BlockLeavesBase=BlockTransparant
BlockTrapDoor=BlockTrapdoor
BlockTripWire=BlockTripwire
BlockTripWireSource=BlockTripwireHook
BlockVine=BlockVine
BlockLilyPad=BlockWaterLily
BlockWeb=BlockWeb
BlockWood=BlockWood
BlockWoodSlab=BlockWoodStep
BlockWorkbench=BlockWorkbench
Chunk=Chunk
RegionFileChunkBuffer=ChunkBuffer
ChunkCache=ChunkCache
ChunkCoordIntPair=ChunkCoordIntPair
ChunkCoordinates=ChunkCoordinates
PortalPosition=ChunkCoordinatesPortal
AnvilSaveConverterFileFilter=ChunkFilenameFilter
Packet51MapChunkData=ChunkMap
ChunkPosition=ChunkPosition
ChunkProviderFlat=ChunkProviderFlat
ChunkProviderGenerate=ChunkProviderGenerate
ChunkProviderHell=ChunkProviderHell
ChunkProviderServer=ChunkProviderServer
ChunkProviderEnd=ChunkProviderTheEnd
AnvilChunkLoader=ChunkRegionLoader
ExtendedBlockStorage=ChunkSection
CommandBase=CommandAbstract
CommandServerBan=CommandBan
CommandServerBanIp=CommandBanIp
CommandServerBanlist=CommandBanList
CommandClearInventory=CommandClear
CommandDebug=CommandDebug
CommandServerDeop=CommandDeop
CommandDifficulty=CommandDifficulty
ServerCommandManager=CommandDispatcher
CommandEnchant=CommandEnchant
CommandException=CommandException
CommandGameMode=CommandGamemode
CommandDefaultGameMode=CommandGamemodeDefault
CommandGameRule=CommandGamerule
CommandGive=CommandGive
CommandHandler=CommandHandler
CommandHelp=CommandHelp
CommandServerKick=CommandKick
CommandKill=CommandKill
CommandServerList=CommandList
CommandServerEmote=CommandMe
CommandServerOp=CommandOp
CommandServerPardon=CommandPardon
CommandServerPardonIp=CommandPardonIP
CommandServerPublishLocal=CommandPublish
CommandServerSaveAll=CommandSaveAll
CommandServerSaveOff=CommandSaveOff
CommandServerSaveOn=CommandSaveOn
CommandServerSay=CommandSay
CommandShowSeed=CommandSeed
CommandSetSpawnpoint=CommandSpawnpoint
CommandServerStop=CommandStop
CommandServerMessage=CommandTell
CommandTime=CommandTime
CommandToggleDownfall=CommandToggleDownfall
CommandServerTp=CommandTp
CommandWeather=CommandWeather
CommandServerWhitelist=CommandWhitelist
CommandXP=CommandXp
NetHandler=Connection
ConsoleLogFormatter=ConsoleLogFormatter
ConsoleLogManager=ConsoleLogManager
Container=Container
ContainerRepair=ContainerAnvil
InventoryRepair=ContainerAnvilInventory
ContainerBeacon=ContainerBeacon
ContainerBrewingStand=ContainerBrewingStand
ContainerChest=ContainerChest
ContainerDispenser=ContainerDispenser
ContainerEnchantment=ContainerEnchantTable
SlotEnchantmentTable=ContainerEnchantTableInventory
ContainerFurnace=ContainerFurnace
ContainerMerchant=ContainerMerchant
ContainerPlayer=ContainerPlayer
ContainerSheep=ContainerSheepBreed
ContainerWorkbench=ContainerWorkbench
EntityJumpHelper=ControllerJump
EntityLookHelper=ControllerLook
EntityMoveHelper=ControllerMove
ConvertingProgressUpdate=ConvertProgressUpdater
ISaveFormat=Convertable
IStatType=Counter
StatBasic=CounterStatistic
CraftingManager=CraftingManager
StatCrafting=CraftingStatistic
CrashReport=CrashReport
CallableCrashMemoryReport=CrashReportAABBPoolSize
CallableBlockDataValue=CrashReportBlockDataValue
CallableBlockLocation=CrashReportBlockLocation
CallableBlockType=CrashReportBlockType
CallableChunkPosHash=CrashReportChunkPosHash
CallableLvl3=CrashReportChunkStats
CallableTagCompound1=CrashReportCorruptNBTTag
CallableTagCompound2=CrashReportCorruptNBTTag2
CrashReportCategoryEntry=CrashReportDetail
CallableEntityType=CrashReportEntityType
CallableIntCache=CrashReportIntCacheSize
CallableIsFeatureChunk=CrashReportIsFeatureChunk
CallableJVMFlags=CrashReportJVMFlags
CallableJavaInfo2=CrashReportJavaVMVersion
CallableJavaInfo=CrashReportJavaVersion
CallableLevelDimension=CrashReportLevelDimension
CallableLevelGamemode=CrashReportLevelGameMode
CallableLevelGenerator=CrashReportLevelGenerator
CallableLevelGeneratorOptions=CrashReportLevelGeneratorOptions
CallableLevelSeed=CrashReportLevelSeed
CallableLevelSpawnLocation=CrashReportLevelSpawnLocation
CallableLevelStorageVersion=CrashReportLevelStorageVersion
CallableLevelTime=CrashReportLevelTime
CallableLevelWeather=CrashReportLevelWeather
CallableMemoryInfo=CrashReportMemory
CallableType=CrashReportModded
CallableOSInfo=CrashReportOperatingSystem
CallableServerMemoryStats=CrashReportPlayerCount
CallableLvl2=CrashReportPlayers
CallableIsServerModded=CrashReportProfilerPosition
CallableLvl1=CrashReportSourceBlockType
CallableStructureType=CrashReportStructureType
CallableSuspiciousClasses=CrashReportSuspiciousClasses
CrashReportCategory=CrashReportSystemDetails
CallableTileEntityName=CrashReportTileEntityName
CallableServerType=CrashReportType
CallableServerProfiler=CrashReportVec3DPoolSize
CallableMinecraftVersion=CrashReportVersion
CreativeTabs=CreativeModeTab
CreativeTabBlock=CreativeModeTab1
CreativeTabBrewing=CreativeModeTab10
CreativeTabMaterial=CreativeModeTab11
CreativeTabInventory=CreativeModeTab12
CreativeTabDeco=CreativeModeTab2
CreativeTabRedstone=CreativeModeTab3
CreativeTabTransport=CreativeModeTab4
CreativeTabMisc=CreativeModeTab5
CreativeTabSearch=CreativeModeTab6
CreativeTabFood=CreativeModeTab7
CreativeTabTools=CreativeModeTab8
CreativeTabCombat=CreativeModeTab9
DamageSource=DamageSource
DataWatcher=DataWatcher
DedicatedPlayerList=DedicatedPlayerList
DedicatedServer=DedicatedServer
DedicatedServerListenThread=DedicatedServerConnection
ServerListenThread=DedicatedServerConnectionThread
DemoWorldManager=DemoPlayerInteractManager
DemoWorldServer=DemoWorldServer
Direction=Direction
BehaviorArrowDispense=DispenseBehaviorArrow
BehaviorDispenseBoat=DispenseBehaviorBoat
BehaviorEggDispense=DispenseBehaviorEgg
BehaviorBucketEmptyDispense=DispenseBehaviorEmptyBucket
BehaviorExpBottleDispense=DispenseBehaviorExpBottle
BehaviorBucketFullDispense=DispenseBehaviorFilledBucket
BehaviorDispenseFireball=DispenseBehaviorFireball
BehaviorDispenseFirework=DispenseBehaviorFireworks
BehaviorDefaultDispenseItem=DispenseBehaviorItem
BehaviorDispenseMinecart=DispenseBehaviorMinecart
BehaviorMobEggDispense=DispenseBehaviorMonsterEgg
BehaviorDispenseItemProvider=DispenseBehaviorNoop
BehaviorPotionDispense=DispenseBehaviorPotion
BehaviorProjectileDispense=DispenseBehaviorProjectile
BehaviorSnowballDispense=DispenseBehaviorSnowBall
BehaviorPotionDispenseLogic=DispenseBehaviorThrownPotion
EntityAINearestAttackableTargetSorter=DistanceComparator
StatTypeDistance=DistancesCounter
EmptyChunk=EmptyChunk
Empty3=EmptyClass
ServerBlockEvent=EmptyClass2
Enchantment=Enchantment
EnchantmentArrowDamage=EnchantmentArrowDamage
EnchantmentArrowKnockback=EnchantmentArrowKnockback
EnchantmentDigging=EnchantmentDigging
EnchantmentDurability=EnchantmentDurability
EnchantmentFireAspect=EnchantmentFire
EnchantmentArrowFire=EnchantmentFlameArrows
EnchantmentArrowInfinite=EnchantmentInfiniteArrows
EnchantmentData=EnchantmentInstance
EnchantmentKnockback=EnchantmentKnockback
EnchantmentLootBonus=EnchantmentLootBonus
EnchantmentHelper=EnchantmentManager
IEnchantmentModifier=EnchantmentModifier
EnchantmentModifierLiving=EnchantmentModifierDamage
EnchantmentModifierDamage=EnchantmentModifierProtection
EnchantmentOxygen=EnchantmentOxygen
EnchantmentProtection=EnchantmentProtection
EnchantmentUntouching=EnchantmentSilkTouch
EnumEnchantmentType=EnchantmentSlotType
EnchantmentThorns=EnchantmentThorns
EnchantmentWaterWorker=EnchantmentWaterWorker
EnchantmentDamage=EnchantmentWeaponDamage
Entity=Entity
EntityBodyHelper=EntityAIBodyControl
EntityAgeable=EntityAgeable
EntityAmbientCreature=EntityAmbient
EntityAnimal=EntityAnimal
EntityArrow=EntityArrow
EntityBat=EntityBat
EntityBlaze=EntityBlaze
EntityBoat=EntityBoat
EntityCaveSpider=EntityCaveSpider
EntityChicken=EntityChicken
EntityDragonPart=EntityComplexPart
EntityCow=EntityCow
EntityCreature=EntityCreature
EntityCreeper=EntityCreeper
EntityDamageSource=EntityDamageSource
EntityDamageSourceIndirect=EntityDamageSourceIndirect
EntityEgg=EntityEgg
EntityEnderCrystal=EntityEnderCrystal
EntityDragon=EntityEnderDragon
EntityEnderPearl=EntityEnderPearl
EntityEnderEye=EntityEnderSignal
EntityEnderman=EntityEnderman
EntityXPOrb=EntityExperienceOrb
EntityFallingSand=EntityFallingBlock
EntityFireball=EntityFireball
EntityFireworkRocket=EntityFireworks
EntityFishHook=EntityFishingHook
EntityFlying=EntityFlying
EntityGhast=EntityGhast
EntityGiantZombie=EntityGiantZombie
EntityGolem=EntityGolem
EntityHanging=EntityHanging
EntityPlayer=EntityHuman
EntityIronGolem=EntityIronGolem
EntityItem=EntityItem
EntityItemFrame=EntityItemFrame
EntityLargeFireball=EntityLargeFireball
EntityLightningBolt=EntityLightning
EntityLiving=EntityLiving
EntityMagmaCube=EntityMagmaCube
EntityMinecart=EntityMinecart
EntityMob=EntityMonster
EntityMooshroom=EntityMushroomCow
EntityOcelot=EntityOcelot
EntityPainting=EntityPainting
EntityPig=EntityPig
EntityPigZombie=EntityPigZombie
EntityPlayerMP=EntityPlayer
EntityPotion=EntityPotion
EntityThrowable=EntityProjectile
FilterIMob=EntitySelectorMonster
EntityWitherAttackFilter=EntitySelectorNotUndead
EntitySenses=EntitySenses
EntitySheep=EntitySheep
EntitySilverfish=EntitySilverfish
EnumEntitySizeHelper=EntitySizes
EntitySkeleton=EntitySkeleton
EntitySlime=EntitySlime
EntitySmallFireball=EntitySmallFireball
EntitySnowball=EntitySnowball
EntitySnowman=EntitySnowman
EntitySpider=EntitySpider
EntitySquid=EntitySquid
EntityTNTPrimed=EntityTNTPrimed
EntityTameable=EntityTameableAnimal
EntityExpBottle=EntityThrownExpBottle
EntityTracker=EntityTracker
EntityTrackerEntry=EntityTrackerEntry
EntityList=EntityTypes
EntityVillager=EntityVillager
EntityWaterMob=EntityWaterAnimal
EntityWeatherEffect=EntityWeather
EntityWitch=EntityWitch
EntityWither=EntityWither
EntityWitherSkull=EntityWitherSkull
EntityWolf=EntityWolf
EntityZombie=EntityZombie
EnumAction=EnumAnimation
EnumArmorMaterial=EnumArmorMaterial
EnumArt=EnumArt
EnumStatus=EnumBedResult
EnumCreatureType=EnumCreatureType
EnumEntitySize=EnumEntitySize
EnumFacing=EnumFacing
EnumGameType=EnumGamemode
EnumMobType=EnumMobType
EnumCreatureAttribute=EnumMonsterType
EnumMovingObjectType=EnumMovingObjectType
EnumSkyBlock=EnumSkyBlock
EnumToolMaterial=EnumToolMaterial
NumberInvalidException=ExceptionInvalidNumber
SyntaxErrorException=ExceptionInvalidSyntax
PlayerNotFoundException=ExceptionPlayerNotFound
CommandNotFoundException=ExceptionUnknownCommand
WrongUsageException=ExceptionUsage
MinecraftException=ExceptionWorldConflict
Explosion=Explosion
Facing=Facing
ThreadedFileIOBase=FileIOThread
FoodStats=FoodMetaData
GameRuleValue=GameRuleValue
GameRules=GameRules
GenLayer=GenLayer
GenLayerBiome=GenLayerBiome
GenLayerAddSnow=GenLayerIcePlains
GenLayerAddIsland=GenLayerIsland
GenLayerAddMushroomIsland=GenLayerMushroomIsland
GenLayerShore=GenLayerMushroomShore
GenLayerHills=GenLayerRegionHills
GenLayerRiver=GenLayerRiver
GenLayerRiverInit=GenLayerRiverInit
GenLayerRiverMix=GenLayerRiverMix
GenLayerSmooth=GenLayerSmooth
GenLayerSwampRivers=GenLayerSwampRivers
GenLayerZoom=GenLayerZoom
GenLayerFuzzyZoom=GenLayerZoomFuzzy
GenLayerVoronoiZoom=GenLayerZoomVoronoi
GuiLogFormatter=GuiLogFormatter
GuiLogOutputHandler=GuiLogOutputHandler
GuiStatsComponent=GuiStatsComponent
GuiStatsListener=GuiStatsListener
HttpUtil=HttpUtilities
IAnimals=IAnimal
IThreadedFileIO=IAsyncChunkSaver
IBlockAccess=IBlockAccess
IChunkLoader=IChunkLoader
IChunkProvider=IChunkProvider
ICommand=ICommand
IAdminCommand=ICommandDispatcher
ICommandManager=ICommandHandler
ICommandSender=ICommandListener
IEntityMultiPart=IComplex
ICrafting=ICrafting
ISaveHandler=IDataManager
IBehaviorDispenseItem=IDispenseBehavior
IEntitySelector=IEntitySelector
IInventory=IInventory
IInvBasic=IInventoryListener
ILocatableSource=ILocationSource
IMerchant=IMerchant
IServer=IMinecraftServer
IPlayerUsage=IMojangStatistics
IMob=IMonster
INetworkManager=INetworkManager
IPosition=IPosition
IProgressUpdate=IProgressUpdate
IProjectile=IProjectile
IRangedAttackMob=IRangedEntity
IRecipe=IRecipe
IRegistry=IRegistry
ILocation=ISource
IBlockSource=ISourceBlock
IUpdatePlayerListBox=IUpdatePlayerListBox
IWorldAccess=IWorldAccess
LowerStringMap=InsensitiveStringMap
PotionHealth=InstantMobEffect
IntCache=IntCache
IntHashMap=IntHashMap
IntHashMapEntry=IntHashMapEntry
InventoryCraftResult=InventoryCraftResult
InventoryCrafting=InventoryCrafting
InventoryEnderChest=InventoryEnderChest
InventoryLargeChest=InventoryLargeChest
InventoryMerchant=InventoryMerchant
InventoryBasic=InventorySubcontainer
Item=Item
ItemAnvilBlock=ItemAnvil
ItemArmor=ItemArmor
ItemAxe=ItemAxe
ItemBed=ItemBed
ItemBlock=ItemBlock
ItemBoat=ItemBoat
ItemBook=ItemBook
ItemWritableBook=ItemBookAndQuill
ItemBow=ItemBow
ItemBucket=ItemBucket
ItemCarrotOnAStick=ItemCarrotStick
ItemCloth=ItemCloth
ItemCoal=ItemCoal
ItemDoor=ItemDoor
ItemDye=ItemDye
ItemEgg=ItemEgg
ItemEnchantedBook=ItemEnchantedBook
ItemEnderEye=ItemEnderEye
ItemEnderPearl=ItemEnderPearl
ItemExpBottle=ItemExpBottle
ItemFireball=ItemFireball
ItemFirework=ItemFireworks
ItemFireworkCharge=ItemFireworksCharge
ItemFishingRod=ItemFishingRod
ItemFlintAndSteel=ItemFlintAndSteel
ItemFood=ItemFood
ItemGlassBottle=ItemGlassBottle
ItemAppleGold=ItemGoldenApple
ItemHangingEntity=ItemHanging
ItemHoe=ItemHoe
ItemLeaves=ItemLeaves
ItemEmptyMap=ItemMapEmpty
ItemBucketMilk=ItemMilkBucket
ItemMinecart=ItemMinecart
ItemMonsterPlacer=ItemMonsterEgg
ItemMultiTextureTile=ItemMultiTexture
ItemSimpleFoiled=ItemNetherStar
ItemPickaxe=ItemPickaxe
ItemPiston=ItemPiston
ItemPotion=ItemPotion
ItemRecord=ItemRecord
ItemRedstone=ItemRedstone
ItemReed=ItemReed
ItemSaddle=ItemSaddle
ItemSeedFood=ItemSeedFood
ItemSeeds=ItemSeeds
ItemShears=ItemShears
ItemSign=ItemSign
ItemSkull=ItemSkull
ItemSnowball=ItemSnowball
ItemSoup=ItemSoup
ItemSpade=ItemSpade
ItemStack=ItemStack
ItemSlab=ItemStep
ItemSword=ItemSword
ItemTool=ItemTool
ItemLilyPad=ItemWaterLily
ItemColored=ItemWithAuxData
ItemMap=ItemWorldMap
ItemMapBase=ItemWorldMapBase
ItemEditableBook=ItemWrittenBook
GenLayerIsland=LayerIsland
StatCollector=LocaleI18n
StringTranslate=LocaleLanguage
LongHashMap=LongHashMap
LongHashMapEntry=LongHashMapEntry
Material=Material
MaterialLogic=MaterialDecoration
MaterialTransparent=MaterialGas
MaterialLiquid=MaterialLiquid
MapColor=MaterialMapColor
MaterialPortal=MaterialPortal
MaterialWeb=MaterialWeb
MathHelper=MathHelper
MemoryConnection=MemoryNetworkManager
MerchantRecipe=MerchantRecipe
MerchantRecipeList=MerchantRecipeList
Profiler=MethodProfiler
RailLogic=MinecartTrackLogic
CryptManager=MinecraftEncryption
MinecraftServer net/minecraft/server/MinecraftServer
PotionEffect=MobEffect
Potion=MobEffectList
PlayerUsageSnooper=MojangStatisticsGenerator
PlayerUsageSnooperThread=MojangStatisticsTask
EntityEggInfo=MonsterEggInfo
MovingObjectPosition=MovingObjectPosition
NBTBase=NBTBase
CompressedStreamTools=NBTCompressedStreamTools
NBTTagByte=NBTTagByte
NBTTagByteArray=NBTTagByteArray
NBTTagCompound=NBTTagCompound
NBTTagDouble=NBTTagDouble
NBTTagEnd=NBTTagEnd
NBTTagFloat=NBTTagFloat
NBTTagInt=NBTTagInt
NBTTagIntArray=NBTTagIntArray
NBTTagList=NBTTagList
NBTTagLong=NBTTagLong
NBTTagShort=NBTTagShort
NBTTagString=NBTTagString
INpc=NPC
PathNavigate=Navigation
TcpConnection=NetworkManager
TcpMasterThread=NetworkMasterThread
TcpMonitorThread=NetworkMonitorThread
TcpReaderThread=NetworkReaderThread
TcpWriterThread=NetworkWriterThread
NextTickListEntry=NextTickListEntry
NibbleArray=NibbleArray
NoiseGenerator=NoiseGenerator
NoiseGeneratorOctaves=NoiseGeneratorOctaves
NoiseGeneratorPerlin=NoiseGeneratorPerlin
BlockEventData=NoteBlockData
ServerBlockEventList=NoteDataList
AnvilConverterData=OldChunk
ChunkLoader=OldChunkLoader
NibbleArrayReader=OldNibbleArray
ComparatorClassSorter=PackageNameComparator
Packet=Packet
Packet0KeepAlive=Packet0KeepAlive
Packet100OpenWindow=Packet100OpenWindow
Packet101CloseWindow=Packet101CloseWindow
Packet102WindowClick=Packet102WindowClick
Packet103SetSlot=Packet103SetSlot
Packet104WindowItems=Packet104WindowItems
Packet105UpdateProgressbar=Packet105CraftProgressBar
Packet106Transaction=Packet106Transaction
Packet107CreativeSetSlot=Packet107SetCreativeSlot
Packet108EnchantItem=Packet108ButtonClick
Packet10Flying=Packet10Flying
Packet11PlayerPosition=Packet11PlayerPosition
Packet12PlayerLook=Packet12PlayerLook
Packet130UpdateSign=Packet130UpdateSign
Packet131MapData=Packet131ItemData
Packet132TileEntityData=Packet132TileEntityData
Packet13PlayerLookMove=Packet13PlayerLookMove
Packet14BlockDig=Packet14BlockDig
Packet15Place=Packet15Place
Packet16BlockItemSwitch=Packet16BlockItemSwitch
Packet17Sleep=Packet17EntityLocationAction
Packet18Animation=Packet18ArmAnimation
Packet19EntityAction=Packet19EntityAction
Packet1Login=Packet1Login
Packet200Statistic=Packet200Statistic
Packet201PlayerInfo=Packet201PlayerInfo
Packet202PlayerAbilities=Packet202Abilities
Packet203AutoComplete=Packet203TabComplete
Packet204ClientInfo=Packet204LocaleAndViewDistance
Packet205ClientCommand=Packet205ClientCommand
Packet20NamedEntitySpawn=Packet20NamedEntitySpawn
Packet22Collect=Packet22Collect
Packet23VehicleSpawn=Packet23VehicleSpawn
Packet24MobSpawn=Packet24MobSpawn
Packet250CustomPayload=Packet250CustomPayload
Packet252SharedKey=Packet252KeyResponse
Packet253ServerAuthData=Packet253KeyRequest
Packet254ServerPing=Packet254GetInfo
Packet255KickDisconnect=Packet255KickDisconnect
Packet25EntityPainting=Packet25EntityPainting
Packet26EntityExpOrb=Packet26AddExpOrb
Packet28EntityVelocity=Packet28EntityVelocity
Packet29DestroyEntity=Packet29DestroyEntity
Packet2ClientProtocol=Packet2Handshake
Packet30Entity=Packet30Entity
Packet31RelEntityMove=Packet31RelEntityMove
Packet32EntityLook=Packet32EntityLook
Packet33RelEntityMoveLook=Packet33RelEntityMoveLook
Packet34EntityTeleport=Packet34EntityTeleport
Packet35EntityHeadRotation=Packet35EntityHeadRotation
Packet38EntityStatus=Packet38EntityStatus
Packet39AttachEntity=Packet39AttachEntity
Packet3Chat=Packet3Chat
Packet40EntityMetadata=Packet40EntityMetadata
Packet41EntityEffect=Packet41MobEffect
Packet42RemoveEntityEffect=Packet42RemoveMobEffect
Packet43Experience=Packet43SetExperience
Packet4UpdateTime=Packet4UpdateTime
Packet51MapChunk=Packet51MapChunk
Packet52MultiBlockChange=Packet52MultiBlockChange
Packet53BlockChange=Packet53BlockChange
Packet54PlayNoteBlock=Packet54PlayNoteBlock
Packet55BlockDestroy=Packet55BlockBreakAnimation
Packet56MapChunks=Packet56MapChunkBulk
Packet5PlayerInventory=Packet5EntityEquipment
Packet60Explosion=Packet60Explosion
Packet61DoorChange=Packet61WorldEvent
Packet62LevelSound=Packet62NamedSoundEffect
Packet6SpawnPosition=Packet6SpawnPosition
Packet70GameEvent=Packet70Bed
Packet71Weather=Packet71Weather
Packet7UseEntity=Packet7UseEntity
Packet8UpdateHealth=Packet8UpdateHealth
Packet9Respawn=Packet9Respawn
PacketCount=PacketCounter
Path=Path
PathEntity=PathEntity
PathPoint=PathPoint
PathFinder=Pathfinder
EntityAIBase=PathfinderGoal
EntityAIArrowAttack=PathfinderGoalArrowAttack
EntityAIAvoidEntity=PathfinderGoalAvoidPlayer
EntityAIBeg=PathfinderGoalBeg
EntityAIBreakDoor=PathfinderGoalBreakDoor
EntityAIMate=PathfinderGoalBreed
EntityAIDefendVillage=PathfinderGoalDefendVillage
EntityAIDoorInteract=PathfinderGoalDoorInteract
EntityAIEatGrass=PathfinderGoalEatTile
EntityAIFleeSun=PathfinderGoalFleeSun
EntityAISwimming=PathfinderGoalFloat
EntityAIFollowOwner=PathfinderGoalFollowOwner
EntityAIFollowParent=PathfinderGoalFollowParent
EntityAIHurtByTarget=PathfinderGoalHurtByTarget
EntityAIWatchClosest2=PathfinderGoalInteract
EntityAIOcelotSit=PathfinderGoalJumpOnBlock
EntityAILeapAtTarget=PathfinderGoalLeapAtTarget
EntityAIWatchClosest=PathfinderGoalLookAtPlayer
EntityAILookAtTradePlayer=PathfinderGoalLookAtTradingPlayer
EntityAIVillagerMate=PathfinderGoalMakeLove
EntityAIAttackOnCollide=PathfinderGoalMeleeAttack
EntityAIMoveIndoors=PathfinderGoalMoveIndoors
EntityAIMoveThroughVillage=PathfinderGoalMoveThroughVillage
EntityAIMoveTwardsRestriction=PathfinderGoalMoveTowardsRestriction
EntityAIMoveTowardsTarget=PathfinderGoalMoveTowardsTarget
EntityAINearestAttackableTarget=PathfinderGoalNearestAttackableTarget
EntityAIOcelotAttack=PathfinderGoalOcelotAttack
EntityAILookAtVillager=PathfinderGoalOfferFlower
EntityAIOpenDoor=PathfinderGoalOpenDoor
EntityAIOwnerHurtByTarget=PathfinderGoalOwnerHurtByTarget
EntityAIOwnerHurtTarget=PathfinderGoalOwnerHurtTarget
EntityAIPanic=PathfinderGoalPanic
EntityAIControlledByPlayer=PathfinderGoalPassengerCarrotStick
EntityAIPlay=PathfinderGoalPlay
EntityAILookIdle=PathfinderGoalRandomLookaround
EntityAIWander=PathfinderGoalRandomStroll
EntityAITargetNonTamed=PathfinderGoalRandomTargetNonTamed
EntityAIRestrictOpenDoor=PathfinderGoalRestrictOpenDoor
EntityAIRestrictSun=PathfinderGoalRestrictSun
EntityAITasks=PathfinderGoalSelector
EntityAITaskEntry=PathfinderGoalSelectorItem
EntityAISit=PathfinderGoalSit
EntityAICreeperSwell=PathfinderGoalSwell
EntityAIFollowGolem=PathfinderGoalTakeFlower
EntityAITarget=PathfinderGoalTarget
EntityAITempt=PathfinderGoalTempt
EntityAITradePlayer=PathfinderGoalTradeWithPlayer
AnvilChunkLoaderPending=PendingChunkToSave
NetLoginHandler=PendingConnection
PlayerCapabilities=PlayerAbilities
PlayerInstance=PlayerChunk
PlayerManager=PlayerChunkMap
NetServerHandler=PlayerConnection
PlayerPositionComparator=PlayerDistanceComparator
IPlayerFileData=PlayerFileData
ItemInWorldManager=PlayerInteractManager
InventoryPlayer=PlayerInventory
ServerConfigurationManager=PlayerList
PlayerListBox=PlayerListBox
PlayerSelector=PlayerSelector
Teleporter=PortalTravelAgent
PositionImpl=Position
PotionHelper=PotionBrewer
ProfilerResult=ProfilerInfo
PropertyManager=PropertyManager
RandomPositionGenerator=RandomPositionGenerator
RecipesArmorDyes=RecipeArmorDye
RecipeFireworks=RecipeFireworks
RecipesIngots=RecipeIngots
RecipesMapCloning=RecipeMapClone
RecipesMapExtending=RecipeMapExtend
RecipeSorter=RecipeSorter
RecipesArmor=RecipesArmor
RecipesCrafting=RecipesCrafting
RecipesDyes=RecipesDyes
RecipesFood=RecipesFood
FurnaceRecipes=RecipesFurnace
RecipesTools=RecipesTools
RecipesWeapons=RecipesWeapons
RedstoneUpdateInfo=RedstoneUpdateInfo
RegionFile=RegionFile
RegionFileCache=RegionFileCache
RegistryDefaulted=RegistryDefault
RegistrySimple=RegistrySimple
RConThreadBase=RemoteConnectionThread
RConConsoleSource=RemoteControlCommandListener
RConThreadMain=RemoteControlListener
RConThreadClient=RemoteControlSession
RConThreadQueryAuth=RemoteStatusChallenge
RConThreadQuery=RemoteStatusListener
RConOutputStream=RemoteStatusReply
ReportedException=ReportedException
DerivedWorldInfo=SecondaryWorldData
WorldServerMulti=SecondaryWorldServer
ServerCommand=ServerCommand
NetworkListenThread=ServerConnection
ServerGUI=ServerGUI
ServerGuiCommandListener=ServerGuiCommandListener
ServerGuiFocusAdapter=ServerGuiFocusAdapter
AnvilSaveHandler=ServerNBTManager
ServerWindowAdapter=ServerWindowAdapter
ShapedRecipes=ShapedRecipes
ShapelessRecipes=ShapelessRecipes
ChatAllowedCharacters=SharedConstants
Slot=Slot
SlotRepair=SlotAnvilResult
SlotArmor=SlotArmor
SlotBeacon=SlotBeacon
SlotBrewingStandIngredient=SlotBrewing
SlotEnchantment=SlotEnchant
SlotFurnace=SlotFurnaceResult
SlotMerchantResult=SlotMerchantResult
SlotBrewingStandPotion=SlotPotionBottle
SlotCrafting=SlotResult
BlockSourceImpl=SourceBlock
SpawnerAnimals=SpawnerCreature
StatBase=Statistic
StatList=StatisticList
RConUtils=StatusChallengeUtils
StepSound=StepSound
StepSoundAnvil=StepSoundAnvil
StepSoundSand=StepSoundLadder
StepSoundStone=StepSoundStone
StringUtils=StripColor
StructureBoundingBox=StructureBoundingBox
MapGenStructure=StructureGenerator
StructureComponent=StructurePiece
StructurePieceBlockSelector=StructurePieceBlockSelector
WeightedRandomChestContent=StructurePieceTreasure
StructureStart=StructureStart
DedicatedServerCommandThread=ThreadCommandReader
ThreadLoginVerifier=ThreadLoginVerifier
ThreadMinecraftServer=ThreadServerApplication
ThreadDedicatedServer=ThreadShutdown
DedicatedServerSleepThread=ThreadSleepForever
TileEntity=TileEntity
TileEntityBeacon=TileEntityBeacon
TileEntityBrewingStand=TileEntityBrewingStand
TileEntityChest=TileEntityChest
TileEntityCommandBlock=TileEntityCommand
TileEntityDispenser=TileEntityDispenser
TileEntityEnchantmentTable=TileEntityEnchantTable
TileEntityEnderChest=TileEntityEnderChest
TileEntityEndPortal=TileEntityEnderPortal
TileEntityFurnace=TileEntityFurnace
TileEntityMobSpawner=TileEntityMobSpawner
TileEntityMobSpawnerSpawnData=TileEntityMobSpawnerData
TileEntityNote=TileEntityNote
TileEntityPiston=TileEntityPiston
TileEntityRecordPlayer=TileEntityRecordPlayer
TileEntitySign=TileEntitySign
TileEntitySkull=TileEntitySkull
StatTypeTime=TimeCounter
Tuple=Tuple
StatTypeSimple=UnknownCounter
Vec3=Vec3D
Vec3Pool=Vec3DPool
Village=Village
VillageAgressor=VillageAggressor
VillageCollection=VillageCollection
VillageDoorInfo=VillageDoor
VillageSiege=VillageSiege
WatchableObject=WatchableObject
WeightedRandom=WeightedRandom
WeightedRandomItem=WeightedRandomChoice
World=World
WorldChunkManager=WorldChunkManager
WorldChunkManagerHell=WorldChunkManagerHell
WorldInfo=WorldData
MapGenBase=WorldGenBase
WorldGenBigTree=WorldGenBigTree
WorldGeneratorBonusChest=WorldGenBonusChest
WorldGenCactus=WorldGenCactus
MapGenRavine=WorldGenCanyon
MapGenCaves=WorldGenCaves
MapGenCavesHell=WorldGenCavesHell
WorldGenClay=WorldGenClay
WorldGenDeadBush=WorldGenDeadBush
WorldGenDesertWells=WorldGenDesertWell
WorldGenDungeons=WorldGenDungeons
WorldGenSpikes=WorldGenEnder
WorldGenFire=WorldGenFire
FlatGeneratorInfo=WorldGenFlatInfo
FlatLayerInfo=WorldGenFlatLayerInfo
WorldGenFlowers=WorldGenFlowers
WorldGenForest=WorldGenForest
WorldGenTallGrass=WorldGenGrass
WorldGenShrub=WorldGenGroundBush
WorldGenHellLava=WorldGenHellLava
WorldGenBigMushroom=WorldGenHugeMushroom
ComponentScatteredFeatureJunglePyramid=WorldGenJungleTemple
StructureScatteredFeatureStones=WorldGenJungleTemplePiece
ComponentScatteredFeaturePieces2=WorldGenJungleTempleUnknown
WorldGenLakes=WorldGenLakes
MapGenScatteredFeature=WorldGenLargeFeature
StructureScatteredFeatureStart=WorldGenLargeFeatureStart
WorldGenGlowStone1=WorldGenLightStone1
WorldGenGlowStone2=WorldGenLightStone2
WorldGenLiquids=WorldGenLiquids
WorldGenHugeTrees=WorldGenMegaTree
WorldGenMinable=WorldGenMinable
MapGenMineshaft=WorldGenMineshaft
ComponentMineshaftCorridor=WorldGenMineshaftCorridor
ComponentMineshaftCross=WorldGenMineshaftCross
StructureMineshaftPieces=WorldGenMineshaftPieces
ComponentMineshaftRoom=WorldGenMineshaftRoom
ComponentMineshaftStairs=WorldGenMineshaftStairs
StructureMineshaftStart=WorldGenMineshaftStart
MapGenNetherBridge=WorldGenNether
ComponentNetherBridgePiece=WorldGenNetherPiece
ComponentNetherBridgeCrossing3=WorldGenNetherPiece1
ComponentNetherBridgeCorridor2=WorldGenNetherPiece10
ComponentNetherBridgeNetherStalkRoom=WorldGenNetherPiece11
ComponentNetherBridgeThrone=WorldGenNetherPiece12
ComponentNetherBridgeCrossing=WorldGenNetherPiece13
ComponentNetherBridgeStartPiece=WorldGenNetherPiece15
ComponentNetherBridgeStairs=WorldGenNetherPiece16
ComponentNetherBridgeEnd=WorldGenNetherPiece2
ComponentNetherBridgeStraight=WorldGenNetherPiece3
ComponentNetherBridgeCorridor3=WorldGenNetherPiece4
ComponentNetherBridgeCorridor4=WorldGenNetherPiece5
ComponentNetherBridgeEntrance=WorldGenNetherPiece6
ComponentNetherBridgeCrossing2=WorldGenNetherPiece7
ComponentNetherBridgeCorridor=WorldGenNetherPiece8
ComponentNetherBridgeCorridor5=WorldGenNetherPiece9
StructureNetherBridgePieceWeight=WorldGenNetherPieceWeight
StructureNetherBridgePieces=WorldGenNetherPieces
StructureNetherBridgeStart=WorldGenNetherStart
WorldGenPumpkin=WorldGenPumpkin
ComponentScatteredFeatureDesertPyramid=WorldGenPyramidPiece
WorldGenReed=WorldGenReed
WorldGenSand=WorldGenSand
ComponentScatteredFeature=WorldGenScatteredPiece
MapGenStronghold=WorldGenStronghold
StructureStrongholdStart=WorldGenStronghold2Start
ComponentStrongholdChestCorridor=WorldGenStrongholdChestCorridor
ComponentStrongholdCorridor=WorldGenStrongholdCorridor
ComponentStrongholdCrossing=WorldGenStrongholdCrossing
EnumDoor=WorldGenStrongholdDoorType
ComponentStrongholdLeftTurn=WorldGenStrongholdLeftTurn
ComponentStrongholdLibrary=WorldGenStrongholdLibrary
ComponentStronghold=WorldGenStrongholdPiece
StructureStrongholdPieceWeight3=WorldGenStrongholdPiece2
StructureStrongholdPieceWeight=WorldGenStrongholdPieceWeight
EnumDoorHelper=WorldGenStrongholdPieceWeight3
StructureStrongholdPieces=WorldGenStrongholdPieces
ComponentStrongholdPortalRoom=WorldGenStrongholdPortalRoom
ComponentStrongholdPrison=WorldGenStrongholdPrison
ComponentStrongholdRightTurn=WorldGenStrongholdRightTurn
ComponentStrongholdRoomCrossing=WorldGenStrongholdRoomCrossing
ComponentStrongholdStraight=WorldGenStrongholdStairs
ComponentStrongholdStairs=WorldGenStrongholdStairs2
ComponentStrongholdStairsStraight=WorldGenStrongholdStairsStraight
ComponentStrongholdStairs2=WorldGenStrongholdStart
StructureStrongholdStones=WorldGenStrongholdStones
StructureStrongholdPieceWeight2=WorldGenStrongholdUnknown
WorldGenSwamp=WorldGenSwampTree
WorldGenTaiga1=WorldGenTaiga1
WorldGenTaiga2=WorldGenTaiga2
WorldGenTrees=WorldGenTrees
MapGenVillage=WorldGenVillage
ComponentVillageHouse2=WorldGenVillageBlacksmith
ComponentVillageHall=WorldGenVillageButcher
ComponentVillageField2=WorldGenVillageFarm
ComponentVillageField=WorldGenVillageFarm2
ComponentVillageHouse4_Garden=WorldGenVillageHouse
ComponentVillageHouse3=WorldGenVillageHouse2
ComponentVillageWoodHut=WorldGenVillageHut
ComponentVillageHouse1=WorldGenVillageLibrary
ComponentVillageTorch=WorldGenVillageLight
ComponentVillage=WorldGenVillagePiece
StructureVillagePieceWeight=WorldGenVillagePieceWeight
StructureVillagePieces=WorldGenVillagePieces
ComponentVillagePathGen=WorldGenVillageRoad
ComponentVillageRoadPiece=WorldGenVillageRoadPiece
StructureVillageStart=WorldGenVillageStart
ComponentVillageStartPiece=WorldGenVillageStartPiece
ComponentVillageChurch=WorldGenVillageTemple
ComponentVillageWell=WorldGenVillageWell
WorldGenVines=WorldGenVines
WorldGenWaterlily=WorldGenWaterLily
ComponentScatteredFeatureSwampHut=WorldGenWitchHut
WorldGenerator=WorldGenerator
SaveFormatOld=WorldLoader
AnvilSaveConverter=WorldLoaderServer
WorldManager=WorldManager
MapData=WorldMap
WorldSavedData=WorldMapBase
MapStorage=WorldMapCollection
MapCoord=WorldMapDecoration
MapInfo=WorldMapHumanTracker
SaveHandler=WorldNBTStorage
WorldProvider=WorldProvider
WorldProviderHell=WorldProviderHell
WorldProviderSurface=WorldProviderNormal
WorldProviderEnd=WorldProviderTheEnd
WorldServer=WorldServer
WorldSettings=WorldSettings
WorldType=WorldType

#================================================#
#= Blocks =#
#================================================#
#------------------------------------------------#
#- Variables -#
#------------------------------------------------#
anvil=ANVIL
beacon=BEACON
bed=BED
bedrock=BEDROCK
mushroomCapBrown=BIG_MUSHROOM_1
mushroomCapRed=BIG_MUSHROOM_2
stairsWoodBirch=BIRCH_WOOD_STAIRS
bookShelf=BOOKSHELF
brewingStand=BREWING_STAND
brick=BRICK
stairsBrick=BRICK_STAIRS
mushroomBrown=BROWN_MUSHROOM
stoneOvenActive=BURNING_FURNACE
cactus=CACTUS
cake=CAKE_BLOCK
carrot=CARROTS
cauldron=CAULDRON
chest=CHEST
blockClay=CLAY
oreCoal=COAL_ORE
cobblestone=COBBLESTONE
stairCompactCobblestone=COBBLESTONE_STAIRS
cobblestoneWall=COBBLE_WALL
cocoaPlant=COCOA
commandBlock=COMMAND
crops=CROPS
deadBush=DEAD_BUSH
railDetector=DETECTOR_RAIL
blockDiamond=DIAMOND_BLOCK
oreDiamond=DIAMOND_ORE
redstoneRepeaterIdle=DIODE_OFF
redstoneRepeaterActive=DIODE_ON
dirt=DIRT
dispenser=DISPENSER
stoneDoubleSlab=DOUBLE_STEP
dragonEgg=DRAGON_EGG
blockEmerald=EMERALD_BLOCK
oreEmerald=EMERALD_ORE
enchantmentTable=ENCHANTMENT_TABLE
enderChest=ENDER_CHEST
endPortal=ENDER_PORTAL
endPortalFrame=ENDER_PORTAL_FRAME
fence=FENCE
fenceGate=FENCE_GATE
fire=FIRE
flowerPot=FLOWER_POT
stoneOvenIdle=FURNACE
glass=GLASS
oreRedstoneGlowing=GLOWING_REDSTONE_ORE
glowStone=GLOWSTONE
railPowered=GOLDEN_RAIL
blockGold=GOLD_BLOCK
oreGold=GOLD_ORE
grass=GRASS
gravel=GRAVEL
ice=ICE
blockSteel=IRON_BLOCK
doorSteel=IRON_DOOR_BLOCK
fenceIron=IRON_FENCE
oreIron=IRON_ORE
pumpkinLantern=JACK_O_LANTERN
jukebox=JUKEBOX
stairsWoodJungle=JUNGLE_WOOD_STAIRS
ladder=LADDER
blockLapis=LAPIS_BLOCK
oreLapis=LAPIS_ORE
lavaMoving=LAVA
leaves=LEAVES
lever=LEVER
lockedChest=LOCKED_CHEST
wood=LOG
tallGrass=LONG_GRASS
melon=MELON
melonStem=MELON_STEM
mobSpawner=MOB_SPAWNER
silverfish=MONSTER_EGGS
cobblestoneMossy=MOSSY_COBBLESTONE
mycelium=MYCEL
netherrack=NETHERRACK
netherBrick=NETHER_BRICK
stairsNetherBrick=NETHER_BRICK_STAIRS
netherFence=NETHER_FENCE
netherStalk=NETHER_WART
music=NOTE_BLOCK
obsidian=OBSIDIAN
pistonBase=PISTON
pistonExtension=PISTON_EXTENSION
pistonMoving=PISTON_MOVING
pistonStickyBase=PISTON_STICKY
portal=PORTAL
potato=POTATOES
pumpkin=PUMPKIN
pumpkinStem=PUMPKIN_STEM
rail=RAILS
redstoneLampIdle=REDSTONE_LAMP_OFF
redstoneLampActive=REDSTONE_LAMP_ON
oreRedstone=REDSTONE_ORE
torchRedstoneIdle=REDSTONE_TORCH_OFF
torchRedstoneActive=REDSTONE_TORCH_ON
redstoneWire=REDSTONE_WIRE
mushroomRed=RED_MUSHROOM
plantRed=RED_ROSE
sand=SAND
sandStone=SANDSTONE
stairsSandStone=SANDSTONE_STAIRS
sapling=SAPLING
signPost=SIGN_POST
skull=SKULL
stoneBrick=SMOOTH_BRICK
snow=SNOW
blockSnow=SNOW_BLOCK
tilledField=SOIL
slowSand=SOUL_SAND
sponge=SPONGE
stairsWoodSpruce=SPRUCE_WOOD_STAIRS
lavaStill=STATIONARY_LAVA
waterStill=STATIONARY_WATER
stoneSingleSlab=STEP
stone=STONE
stoneButton=STONE_BUTTON
pressurePlateStone=STONE_PLATE
stairsStoneBrickSmooth=STONE_STAIRS
reed=SUGAR_CANE_BLOCK
thinGlass=THIN_GLASS
tnt=TNT
torchWood=TORCH
trapdoor=TRAP_DOOR
tripWire=TRIPWIRE
tripWireSource=TRIPWIRE_SOURCE
vine=VINE
signWall=WALL_SIGN
waterMoving=WATER
waterlily=WATER_LILY
web=WEB
whiteStone=WHITESTONE
planks=WOOD
doorWood=WOODEN_DOOR
woodenButton=WOOD_BUTTON
woodDoubleSlab=WOOD_DOUBLE_STEP
pressurePlatePlanks=WOOD_PLATE
stairCompactPlanks=WOOD_STAIRS
woodSingleSlab=WOOD_STEP
cloth=WOOL
workbench=WORKBENCH
plantYellow=YELLOW_FLOWER
blocksList=byId
blockParticleGravity=cA
blockConstructorCalled=cp
enableStats=cq
needsRandomTick=cr
displayOnCreativeTab=creativeTab
soundPowderFootstep=d
blockResistance=durability
soundWoodFootstep=e
soundGravelFootstep=f
slipperiness=frictionFactor
soundGrassFootstep=g
soundStoneFootstep=h
soundMetalFootstep=i
blockID=id
isBlockContainer=isTileEntity
soundGlassFootstep=j
soundClothFootstep=k
soundSandFootstep=l
lightOpacity=lightBlock
lightValue=lightEmission
soundSnowFootstep=m
blockMaterial=material
maxX=maxX
maxY=maxY
maxZ=maxZ
minX=minX
minY=minY
minZ=minZ
soundLadderFootstep=n
blockName=name
soundAnvilFootstep=o
opaqueCubeLookup=q
canBlockGrass=s
stepSound=stepSound
blockHardness=strength
blockIndexInTexture=textureId
requiresSelfNotify=u
useNeighborBrightness=v

#------------------------------------------------#
#- Functions -#
#------------------------------------------------#
getBlockBoundsMaxZ=A
getEnableStats=C
disableStats=D
getBlockName=a
setLightValue=a
setBlockBounds=a
getBlockTextureFromSide=a
getBlockTextureFromSideAndMetadata=a
canCollideCheck=a
quantityDropped=a
setCreativeTab=a
getExplosionResistance=a
canDropFromExplosion=a
setStepSound=a
isVecInsideYZBounds=a
onBlockHarvested=a
addCollidingBlockToList=a
onEntityCollidedWithBlock=a
onFallenUpon=a
velocityToAddToEntity=a
collisionRayTrace=a
harvestBlock=a
isBlockSolid=a_
onBlockClicked=attack
renderAsNormalBlock=b
setResistance=b
setBlockName=b
isProvidingWeakPower=b
isVecInsideXZBounds=b
onBlockEventReceived=b
updateTick=b
onEntityWalking=b
dropBlockAsItem_do=b
setTickRandomly=b
isOpaqueCube=c
setHardness=c
getBlocksMovement=c
isProvidingStrongPower=c
isVecInsideXYBounds=c
dropBlockAsItem=c
canPlaceBlockAt=canPlace
canPlaceBlockOnSide=canPlace
getRenderType=d
canBlockStay=d
onNeighborBlockChange=doPhysics
dropBlockAsItemWithChance=dropNaturally
getCollisionBoundingBoxFromPool=e
setBlockBoundsForItemRender=f
fillWithRain=f
dropXpOnBlockBreak=f
createStackedBlock=f_
getPlayerRelativeBlockHardness=getDamage
quantityDroppedWithBonus=getDropCount
damageDropped=getDropData
getDamageValue=getDropData
idDropped=getDropType
translateBlockName=getName
onBlockPlaced=getPlacedData
setLightOpacity=h
onSetBlockIDWithMetaData=h
isNormalCube=i
onBlockActivated=interact
canProvidePower=isPowerSource
getTickRandomly=isTicking
func_82506_l=l
isCollidable=m
getBlockHardness=m
onBlockAdded=onPlace
onBlockDestroyedByPlayer=postBreak
onPostBlockPlaced=postPlac
onBlockPlacedBy=postPlace
getMobilityFlag=q_
setRequiresSelfNotify=r
tickRate=r_
breakBlock=remove
setBlockUnbreakable=s
canSilkHarvest=s_
initializeBlock=t_
hasTileEntity=u
setBlockBoundsBasedOnState=updateShape
getMinX=v
getBlockBoundsMaxX=w
onBlockDestroyedByExplosion=wasExploded
getBlockBoundsMinY=x
getBlockBoundsMaxY=y
getBlockBoundsMinZ=z


#================================================#
#= Items =#
#================================================#
appleRed=APPLE
arrow=ARROW
bed=BED
blazePowder=BLAZE_POWDER
blazeRod=BLAZE_ROD
boat=BOAT
bone=BONE
book=BOOK
writableBook=BOOK_AND_QUILL
bow=BOW
bowlEmpty=BOWL
bread=BREAD
brewingStand=BREWING_STAND
bucketEmpty=BUCKET
cake=CAKE
carrot=CARROT
goldenCarrot=CARROT_GOLDEN
carrotOnAStick=CARROT_STICK
cauldron=CAULDRON
bootsChain=CHAINMAIL_BOOTS
plateChain=CHAINMAIL_CHESTPLATE
helmetChain=CHAINMAIL_HELMET
legsChain=CHAINMAIL_LEGGINGS
clay=CLAY_BALL
brick=CLAY_BRICK
coal=COAL
compass=COMPASS
beefCooked=COOKED_BEEF
chickenCooked=COOKED_CHICKEN
fishCooked=COOKED_FISH
cookie=COOKIE
diamond=DIAMOND
axeDiamond=DIAMOND_AXE
bootsDiamond=DIAMOND_BOOTS
plateDiamond=DIAMOND_CHESTPLATE
helmetDiamond=DIAMOND_HELMET
hoeDiamond=DIAMOND_HOE
legsDiamond=DIAMOND_LEGGINGS
pickaxeDiamond=DIAMOND_PICKAXE
shovelDiamond=DIAMOND_SPADE
swordDiamond=DIAMOND_SWORD
redstoneRepeater=DIODE
egg=EGG
emerald=EMERALD
field_92053_bW=ENCHANTED_BOOK
enderPearl=ENDER_PEARL
expBottle=EXP_BOTTLE
eyeOfEnder=EYE_OF_ENDER
feather=FEATHER
fermentedSpiderEye=FERMENTED_SPIDER_EYE
fireballCharge=FIREBALL
field_92052_bU=FIREWORKS
field_92054_bV=FIREWORKS_CHARGE
fishingRod=FISHING_ROD
flint=FLINT
flintAndSteel=FLINT_AND_STEEL
flowerPot=FLOWER_POT
ghastTear=GHAST_TEAR
glassBottle=GLASS_BOTTLE
lightStoneDust=GLOWSTONE_DUST
appleGold=GOLDEN_APPLE
axeGold=GOLD_AXE
bootsGold=GOLD_BOOTS
plateGold=GOLD_CHESTPLATE
helmetGold=GOLD_HELMET
hoeGold=GOLD_HOE
ingotGold=GOLD_INGOT
legsGold=GOLD_LEGGINGS
goldNugget=GOLD_NUGGET
pickaxeGold=GOLD_PICKAXE
shovelGold=GOLD_SPADE
swordGold=GOLD_SWORD
porkCooked=GRILLED_PORK
dyePowder=INK_SACK
axeSteel=IRON_AXE
bootsSteel=IRON_BOOTS
plateSteel=IRON_CHESTPLATE
doorSteel=IRON_DOOR
helmetSteel=IRON_HELMET
hoeSteel=IRON_HOE
ingotIron=IRON_INGOT
legsSteel=IRON_LEGGINGS
pickaxeSteel=IRON_PICKAXE
shovelSteel=IRON_SPADE
swordSteel=IRON_SWORD
itemFrame=ITEM_FRAME
bucketLava=LAVA_BUCKET
leather=LEATHER
bootsLeather=LEATHER_BOOTS
plateLeather=LEATHER_CHESTPLATE
helmetLeather=LEATHER_HELMET
legsLeather=LEATHER_LEGGINGS
magmaCream=MAGMA_CREAM
map=MAP
emptyMap=MAP_EMPTY
melon=MELON
melonSeeds=MELON_SEEDS
bucketMilk=MILK_BUCKET
minecartEmpty=MINECART
monsterPlacer=MONSTER_EGG
bowlSoup=MUSHROOM_SOUP
netherStalkSeeds=NETHER_STALK
netherStar=NETHER_STAR
painting=PAINTING
paper=PAPER
porkRaw=PORK
potato=POTATO
bakedPotato=POTATO_BAKED
poisonousPotato=POTATO_POISON
potion=POTION
minecartPowered=POWERED_MINECART
pumpkinPie=PUMPKIN_PIE
pumpkinSeeds=PUMPKIN_SEEDS
beefRaw=RAW_BEEF
chickenRaw=RAW_CHICKEN
fishRaw=RAW_FISH
record13=RECORD_1
recordWard=RECORD_10
record11=RECORD_11
recordWait=RECORD_12
recordCat=RECORD_2
recordBlocks=RECORD_3
recordChirp=RECORD_4
recordFar=RECORD_5
recordMall=RECORD_6
recordMellohi=RECORD_7
recordStal=RECORD_8
recordStrad=RECORD_9
redstone=REDSTONE
rottenFlesh=ROTTEN_FLESH
saddle=SADDLE
seeds=SEEDS
shears=SHEARS
sign=SIGN
skull=SKULL
slimeBall=SLIME_BALL
snowball=SNOW_BALL
speckledMelon=SPECKLED_MELON
spiderEye=SPIDER_EYE
stick=STICK
axeStone=STONE_AXE
hoeStone=STONE_HOE
pickaxeStone=STONE_PICKAXE
shovelStone=STONE_SPADE
swordStone=STONE_SWORD
minecartCrate=STORAGE_MINECART
silk=STRING
sugar=SUGAR
reed=SUGAR_CANE
gunpowder=SULPHUR
pocketSundial=WATCH
bucketWater=WATER_BUCKET
wheat=WHEAT
axeWood=WOOD_AXE
doorWood=WOOD_DOOR
hoeWood=WOOD_HOE
pickaxeWood=WOOD_PICKAXE
shovelWood=WOOD_SPADE
swordWood=WOOD_SWORD
writtenBook=WRITTEN_BOOK
tabToDisplayOn=a
itemsList=byId
bFull3D=cm
hasSubtypes=cn
potionEffect=co
containerItem=craftingResult
itemRand=d
maxDamage=durability
itemID=id
maxStackSize=maxStackSize
itemName=name
iconIndex=textureId

#================================================#
#= CreativeTabs =#
#================================================#
creativeTabArray=a
tabBlock=b
tabDecorations=c
tabRedstone=d
tabTransport=e
tabMisc=f
tabAllSearch=g
tabFood=h
tabTools=i
tabCombat=j
tabBrewing=k
tabMaterials=l
tabInventory=m
tabIndex=n
tabLabel=o
theTexture=p
hasScrollbar=q
drawTitle=r